fish	cat	mouse	dog
sun	cloud	car	house
corn	tree	cake	apple
balloon	kite	yo-yo	ball
moon	star	bed	teddy bear
train	truck	boat	bus
cup	can	box	bag
hand	back	nose	animals
red	yellow	blue	green
black	brown	white	pink
monkey	bee	duck	bear
clown	king	boy	man
on	off	open	close
day	night	hot	cold
run	walk	sit	stand
clown	cake	ball	cat
bee	cloud	apple	train
boat	bus	dog	bed
kite	balloon	fish	duck
truck	box	bag	can
on	off	animals	boy
stand	walk	run	sit
moon	star	king	car
open	close	cold	hot
red	black	yellow	green
cup	corn	mouse	house
man	hand	nose	back
blue	pink	brown	white
night	day	sun	tree
monkey	teddy bear	yo-yo	bear
stop	go	loud	quiet
eat	drink	wet	dry
big	small	yes	no
saw	rake	table	fall
moo	quack	meow	yell
sad	cry	mad	jump
swim	spell	sleep	dream
cut	fold	zip	grow
talk	pet	smell	hug
queen	pig	fat	tall
swing	slide	bat	top
row	float	sink	blow
hit	clap	popcorn	witch
rain	snow	fire	sand
robot	upside-down	up	down
moo	meow	quack	talk
table	fall	mad	sad
bat	hit	popcorn	dream
row	sink	dry	wet
spell	jump	zip	swim
rake	swing	pet	hug
smell	drink	cut	eat
big	small	saw	top
yell	quiet	sleep	loud
up	upside-down	down	queen
dad	school	slide	clap
sand	float	rain	cry
stop	go	pig	grow
witch	robot	fat	tall
fold	snow	blow	fire
bear	boat	bus	bee
bed	balloon	big	bat
balloon	barn	back	bell
box	bib	boy	blow
bag	blue	black	brown
monkey	mitten	meat	mop
mouse	mice	moo	meow
moon	map	man	mad
hat	house	hug	hand
horse	hit	hot	hot dog
pot	pan	pineapple	potato
piano	pear	pumpkin	paw
pants	pen	purse	pin
pig	pet	push	pull
pink	pillow	popcorn	plants
nest	nail	nut	night
nose	net	nurse	no
duck	dinosaur	donkey	dog
door	down	drum	dream
day	dig	dry	drink
tree	truck	train	tomato
tire	toys	teddy bear	table
tall	tail	turtle	two
talk	tape	tie	top
wet	wall	wagon	watermelon
woman	wing	witch	wood
window	walk	white	wheel
king	kite	kitten	kangaroo
umbrella	underwear	up	upside-down
elephant	elbow	egg	end
fish	frog	fat	flower
fox	farm	flag	free
fold	fall	fight	float
fire	finger	floor	fan
green	gray	gold	go
goat	glue	grow	guitar
lollipop	lamp	lock	loud
log	lake	leaf	lemon
yellow	yarn	yell	yo-yo
jar	jeep	jail	jump
rabbit	rain	raincoat	rainbow
rake	robot	run	row
ring	red	raccoon	roses
sun	snake	sand	sandbox
stand	sit	swim	sleep
slide	swing	saw	seesaw
snow	snowman	sad	small
sock	stop	spell	smell
snail	sail	sink	star
spoon	stamp	straw	sandwich
corn	cup	cake	can
car	cow	clown	cloud
cat	cold	clock	crib
cut	cry	clap	close
in	ink	invisible	igloo
van	vest	vacuum	vegetables
apple	ants	animals	alphabet
octopus	ox	on	off
queen	quilt	quiet	quack
zebra	zip	zigzag	zoo
